1 2 1 2 1 2 1 2 1 2 1 2 1
6 2 2 2 2 2 2 2 2 2 2 2 6
6 1 3 1 4 1 5 1 4 1 3 1 6
6 3 3 4 4 5 5 5 4 4 3 3 6
6 1 3 1 4 1 5 1 4 1 3 1 6
6 6 3 3 6 6 5 6 6 3 3 6 6